Lane,SampleID,Index,# Reads,# Perfect Index Reads,# One Mismatch Index Reads,# of >= Q30 Bases (PF),Mean Quality Score (PF)
1,BLANK_43_12G_A1,CCGACTAT-AAGGCTGA,17746791,16569635,1177156,5117161894,36.22
1,BLANK_43_12H_A3,ACCGACAA-CGATCGAT,6258318,6015651,242667,1814746084,36.33
1,RMA_KHP_rpoS_Mage_Q97D_A5,CCGACTAT-TTACCGAG,17050504,15833661,1216843,4881649763,36.09
1,RMA_KHP_rpoS_Mage_Q97L_A7,CTTCGCAA-AAGACACC,7333779,7033596,300183,2117157098,36.23
1,RMA_KHP_rpoS_Mage_Q97N_A9,GCCTTGTT-GTCCTAAG,11220302,10662457,557845,3250778684,36.31
1,RMA_KHP_rpoS_Mage_Q97E_A11,AACACCAC-CATCTGCT,5742981,5467266,275715,1644567308,36.12
1,JBI_KHP_HGL_021_A13,AACTTGCC-GAAGGTTC,11095007,10515926,579081,3209222154,36.28
1,JBI_KHP_HGL_022_A15,CGTATCTC-CTCTCAGA,9351569,8904967,446602,2661466864,36.04
1,JBI_KHP_HGL_023_A17,CAATGTGG-GAAGAGGT,13197696,12742595,455101,3801874508,36.21
1,JBI_KHP_HGL_024_A19,GGTACGAA-TCGTCTGA,13232733,12692455,540278,3821644342,36.25
1,AP581451B02_A21,TCTGAGAG-CTCTCAGA,14568707,13911718,656989,4197952639,36.2
1,EP256645B01_A23,ACCGCATA-TCGTCTGA,16780973,16109750,671223,4832953180,36.2
1,EP112567B02_C1,GAAGTACC-CAATAGCC,8652741,8240257,412484,2497520429,36.23
1,EP337425B01_C3,CAGGTATC-CATTCGTC,2861746,2738889,122857,822235391,36.18
1,LP127890A01_C5,TCTCTAGG-AGTGGCAA,4075524,3911828,163696,1173349468,36.21
1,EP159692B04_C7,AAGCACTG-GTGGTATG,10309787,9958045,351742,2978494624,36.24
1,EP987683A01_C9,CCAAGCAA-TGAGCTGT,52376,50644,1732,15051821,36.17
1,AP959450A03_C11,TGTTCGAG-CGTCAAGA,896790,869768,27022,255135706,36.04
1,SP464350A04_C13,CTCGTCTT-AAGCATCG,10066259,9754432,311827,2906102548,36.25
1,EP121011B01_C15,TCGGTTAC-ACCTCTTC,12076072,11380620,695452,3470917613,36.17
1,BLANK_43_12G_A2,TCTGAGAG-AAGCACTG,2717525,2615549,101976,773401265,36.04
1,BLANK_43_12H_A4,CAATAGCC-CGTCAAGA,3262363,3134199,128164,936742399,36.16
1,RMA_KHP_rpoS_Mage_Q97D_A6,ACCGCATA-CCAAGCAA,5533933,5312488,221445,1596429252,36.25
1,RMA_KHP_rpoS_Mage_Q97L_A8,CATTCGTC-AAGCATCG,4449051,4279856,169195,1257036068,35.89
1,RMA_KHP_rpoS_Mage_Q97N_A10,GAAGTACC-TGTTCGAG,7988098,7605865,382233,2253845540,35.75
1,RMA_KHP_rpoS_Mage_Q97E_A12,AGTGGCAA-TACTCCAG,6983895,6668201,315694,2001001350,36.12
1,JBI_KHP_HGL_021_A14,CAGGAATC-CTCGTCTT,3988247,3816655,171592,1151003190,36.25
1,JBI_KHP_HGL_022_A16,GTGGAATG-GATACCTG,248283,234283,14000,71477103,36.2
1,JBI_KHP_HGL_023_A18,TCTCAAGG-CGAACTGT,15076839,14285065,791774,4332910532,36.16
1,JBI_KHP_HGL_024_A20,TGAGATGT-ACCTCTTC,2896918,2727511,169407,832020689,36.17
1,AP581451B02_A22,TCTGAAAG-ATCTCAGA,2732258,2536249,196009,788655858,36.25
1,EP256645B01_A24,ACAGCATA-TGGTCTGA,25782,24652,1130,7351173,36.01
1,EP112567B02_C2,GAAATACC-CATTAGCC,1366114,1304693,61421,391264611,36.13
1,EP337425B01_C4,CAGATATC-CAGTCGTC,2120142,2037097,83045,610689978,36.22
1,LP127890A01_C6,TCTATAGG-AGTCGCAA,6394990,6041349,353641,1830697824,36.12
1,EP159692B04_C8,AAGTTATG-GTGGAATG,11189179,10829148,360031,3159643693,35.93
1,EP987683A01_C10,ACAAGCAA-TGAGCTGT,4346390,4102177,244213,1249860227,36.19
1,AP959450A03_C12,AGTTCGAG-CGTCCAGA,12559328,12113398,445930,3614429056,36.19
1,SP464350A04_C14,ATCGTCTT-AAGAATCG,2562731,2424059,138672,741317990,36.29
1,EP121011B01_C16,ACGGTTAC-ACCACTTC,9583329,9173286,410043,2760240668,36.2
1,BLANK_43_12G_B2,AATTCGGT-GTATTAGC,833366,805729,27637,240688918,36.26
1,BLANK_43_12H_B4,TCGGACTT-CACTGAAG,11016700,10581516,435184,3176977145,36.23
1,RMA_KHP_rpoS_Mage_Q97D_B6,TCGGTAAC-AGTCGCTT,6684162,5277078,1407084,1933470795,36.28
1,RMA_KHP_rpoS_Mage_Q97L_B8,CATGTGTG-CACAGGAA,16529,15838,691,4688004,35.92
1,RMA_KHP_rpoS_Mage_Q97N_B10,AAGTCGAG-TGGCACTA,371534,344494,27040,106932073,36.22
1,RMA_KHP_rpoS_Mage_Q97E_B12,TGCCTCAA-CCATGAAC,6397070,6114423,282647,1845648692,36.24
1,JBI_KHP_HGL_021_B14,TATCGGTC-GGTTGTCA,4308018,4117964,190054,1246186967,36.29
1,JBI_KHP_HGL_022_B16,ATCTGACC-GCCAATAC,4826492,4636279,190213,1388217104,36.2
1,JBI_KHP_HGL_023_B18,TATTCGCC-AACCTCCT,224244,216312,7932,64057677,36.11
1,JBI_KHP_HGL_024_B20,CACAGACT-AGCTACCA,4111702,3851977,259725,1185954143,36.24
1,AP581451B02_B22,GCTGAGAG-CTCTCAGA,594268,573081,21187,169265450,36.06
1,EP256645B01_B24,GCCGCATA-TCGTCTGA,6250019,5948698,301321,1808326305,36.29
1,EP112567B02_D2,GGAGTACC-CAATAGCC,19074237,18330991,743246,5498331200,36.22
1,EP337425B01_D4,CGGGTATC-CATTCGTC,5409411,5221813,187598,1557003408,36.2
1,LP127890A01_D6,TGTCTAGG-AGTGGCAA,5816252,5581075,235177,1681652639,36.28
1,EP159692B04_D8,AGGCACTG-GTGGTATG,6186869,5952473,234396,1789130174,36.29
1,EP987683A01_D10,GCAAGCAA-TGAGCTGT,4094045,3910650,183395,1175943640,36.17
1,AP959450A03_D12,GGTTCGAG-CGTCAAGA,6037138,5778077,259061,1743836011,36.26
1,SP464350A04_D14,GTCGTCTT-AAGCATCG,10743544,10338110,405434,3095626988,36.2
1,EP121011B01_D16,GCGGTTAC-ACCTCTTC,9052,8764,288,2610426,36.23
